MF,MF,MF,MF,MF,MF,MF,MF,MF,MF
9912,9502,9302,9202,9504,9002,9914,9506,9916,9402
MF,MF,MF,MF,MF,MF,MF,MF,MF,MF
9566,9004,9918,9508,9404,9510,9920,9006,9206,9572
MF,MF,MF,MF,MF,MF,MF,MF,MF,MF
9406,9922,9512,9924,9208,9308,9210,9008,9514,9926
MF,MF,MF,MF,MF,MF,MF,MF,MF
9406,9516,9928,9992,9212,9984,9010,9570,9518
MF,MF,MF,MF,MF,MF,MF,MF,MF,MF,MF,MF,MF
9408,9932,9214,9520,9934,9014,9936,9522,9938,9016,9940,9524,9942
MF,MF,MF,MF,MF,MF,MF,MF,MF,MF,MF
9018,9944,9526,9020,9946,9528,9022,9948,9530,9950,9532
MF,MF,MF,MF,MF,MF,MF,MF,MF,MF
9024,9952,9534,9954,9536,9026,9956,9538,9958,9540
MF,MF,MF,MF,MF,MF,MF,MF,MF,MF,MF
9028,9960,9542,9962,9544,9030,9964,9546,9966,9548,9032
MF,MF,MF,MF,MF,MF,MF,MF,MF,MF
9968,9550,9034,9970,9552,9036,9554,9972,9038,9556
MF,MF,MF,MF,MF,MF,MF,MF,MF,MF,MF
9988,9040,9974,9558,9042,9560,9976,9044,9978,9562,9046
MTH,MF,MF,MF,MF,MF
9986,9564,9980,9048,9568,9982